xxxxxxxxxxxxxxxxx            xxxxxxxxxxxxxxxxxxxxx
x               xxxxx    xxxx                    x
x                    xxxx                        x
x                      x                         x
x         xxxxxxxxx    x              *          x
x         x            x    *                    x
x         x   xxxxxxxxxx                         x
x         x            x          *              x
x  *      x            x                         x
x         x            x                         x
x         x            x                         x
x         x       *                              x
x         x                                      x
x         x                                      x
xxxxxxxxxxxxxxxxxxxxxxxxxxxxxxxxxxxxxxxxxxxxxxxxxx